#######
#.   .#
#  $  #
#  $  #
#     #
#  @  #
#######
